2. Bundesliga
1860: TSV 1860 München
EBS: Eintracht Braunschweig
FCN: 1. FC Nürnberg
FCP: FC St. Pauli
FCU: 1. FC Union Berlin
FOR: Fortuna Düsseldorf
FSV: FSV Frankfurt
GRE: SpVgg Greuther Fürth
HEI: 1. FC Heidenheim 1846
KAI: 1. FC Kaiserslautern
KAR: Karlsruher SC
PAD: SC Paderborn 07
RBL: Red Bull Leipzig
SCF: SC Freiburg
SVS: SV Sandhausen
VFL: VfL Bochum

3. Liga
AUE: Erzgebirge Aue
VFR: VfR Aalen

Bundesliga
B04: Bayer Leverkusen
BAY: FC Bayern München
BMG: Bor. Mönchengladbach
BSC: Hertha BSC
BVB: Borussia Dortmund
DAR: SV Darmstadt 98
FCA: FC Augsburg
FCI: FC Ingolstadt 04
FCK: 1. FC Köln
H96: Hannover 96
HSV: Hamburger SV
M05: 1. FSV Mainz 05
S04: FC Schalke 04
SGE: Eintracht Frankfurt
SVW: Werder Bremen
TSG: TSG 1899 Hoffenheim
VFB: VfB Stuttgart
WOB: VfL Wolfsburg

Champions League
ASTA: FC Astana
CSK: CSKA Moscow
DIN: GNK Dinamo Zagreb
DYK: Dynamo Kyiv
GSK: Galatasaray SK
MFF: Malmö FF
MTA: Maccabi Tel Aviv
OLA: Olympiacos F.C.
SHA: Shakhtar Donetsk
ZEN: FC Zenit St. Petersburg

Eredivisie
PSV: PSV Eindhoven

La Liga
ATM: Club Atlético de Madrid
BET: Real Betis
BIL: Athletic Club
EIB: SD Eibar
ESP: RCD Espanyol
FCB: FC Barcelona
FCG: Getafe CF
GCF: Granada CF
LAC: RC Deportivo La Coruna
LUD: Levante UD
MAD: Real Madrid CF
MAL: Málaga CF
RAY: Rayo Vallecano de Madrid
RSS: Real Sociedad de Fútbol
SEV: Sevilla FC
VAL: Valencia CF
VCF: Villarreal CF
VIG: RC Celta de Vigo

League One
SUSFC: Sheffield United FC

Ligue 1
BOR: FC Girondins de Bordeaux
ETI: AS Saint-Étienne
GUI: EA Guingamp
LOR: FC Lorient
MAR: Olympique de Marseille
MHSC: Montpellier Hérault SC
MON: AS Monaco FC
NAN: FC Nantes
NIC: OGC Nice
OLY: Olympique Lyonnais
OSC: OSC Lille
PSG: Paris Saint-Germain
REI: Stade de Reims
REN: Stade Rennais FC
SCB: SC Bastia
SMC: SM Caen
TOU: Toulouse FC

Ligue 2
EVA: Évian Thonon Gaillard FC
FCM: FC Metz
PFC: Paris FC
RCL: RC Lens

Premier League
AFC: Arsenal FC
AFCB: AFC Bournemouth
AVFC: Aston Villa FC
CFC: Chelsea FC
CRY: Crystal Palace FC
EFC: Everton FC
LCFC: Leicester City FC
LFC: Liverpool FC
MCFC: Manchester City FC
MUFC: Manchester United FC
NCFC: Norwich City FC
NUFC: Newcastle United FC
SCFC: Stoke City FC
SFC: Southampton FC
SUN: Sunderland AFC
SWA: Swansea City FC
THFC: Tottenham Hotspur FC
WAT: Watford FC
WBA: West Bromwich Albion FC
WHU: West Ham United FC

Primeira Liga
FCP: FC Porto
SCP: Sporting CP
SLB: SL Benfica

Segunda Division
CCF: Córdoba CF
CFE: Elche FC
UDA: UD Almeria

Serie A
ACM: AC Milan
EMP: Empoli FC
FCT: Torino FC
FIO: ACF Fiorentina
GEN: Genoa CFC
INT: FC Internazionale Milano
JUVE: Juventus Turin
LAZ: SS Lazio
PAL: US Cittá di Palermo
ROM: AS Roma
SASS: US Sassuolo Calcio
SSC: SSC Napoli

